11111111111111111111
10000001111100000011
10111101111101111011
10111101111101111011
10111100000001111011
10111111111111111011
10111111111111111011
10110001100000000011
10110101101111111111
10000100001111111111
11111111111111111111