11111111111111111111
10000111111111111111
10110111111111111111
10110000001111111111
10111111101111111111
10000000001111111111
11111111111111111111
11111111111111111111
11111111111111111111